[
    {
        "type": "mapgen",
        "method": "json",
        "weight": 1000,
        "om_terrain": [ 
            [ "mdx_special_military_base_2", "mdx_special_military_base_1" ],
            [ "mdx_special_military_base_4", "mdx_special_military_base_3" ]
        ],
        "object": {
            "fill_ter": "t_floor",
            "rows": [
                
                "                                                ",
                " |||||||||||||||||||||||||||||||||||||||||||||| ",
                " |||||||||||||||||||||||||||||||||||||||||||||| ",
                " ||GG.G.GG|mm.mm||||q.q22q.q|||||FFFODkkDOFFF|| ",
                " ||i..Gz.i|m...m|||.Q.Q__Q.Q.||||.....i..z...|| ",
                " ||GG.G.GG|.....||W.._.__._..W|||..z..x......|| ",
                " ||.z.G...|m.i.m||w....__....w|||bTTbbTbT..z.|| ",
                " ||GG.G.GG|m.x.m||w____II____w|||bTTbbTbT....|| ",
                " ||...x.z.|..Z..||w....__....w|||bTTbbTbT.z..|| ",
                " ||a..iZ..|m...m||W.._.__._..W|||bTTbbTbT....|| ",
                " ||aaaa...|mm.mm|||W_..__.._W||||bTTbbTbT.Z..|| ",
                " |||||||*||||*||||||W..__..W|||||..z..i..x...|| ",
                " ||=uu=|._z.._.||||||||__||||||||....z.......|| ",
                " ||=..=|._..__.||||||||II|||||||||||||||||+|||| ",
                " ||.x..|._.i_..|=v=v=|X__X|o.+.|AA.AssA.A...P|| ",
                " ||=..=|._.x_z.|=.=.=||__|||||.|......i..x...|| ",
                " ||=iz=|._.z_..|..x..|X__X|o.+.|..x..ppp..z.E|| ",
                " ||L...|._.._._+.zxiL||II|||||i|...z.ppp.....|| ",
                " ||.z..+_______+..Z..|X__X|o.+.|ST..Z.iz.z..t|| ",
                " ||=.Z=|..._.x.|=.=.=||__|||||.|STTT....x....|| ",
                " ||=..=|.Z._...|=v=v=||**||o.+.|SSSSS........|| ",
                " |||||||||++|||||||||||**|||||+|||||||||||+|||| ",
                " ||2...x.i..z..Z...x...II....z......x.i.....2|| ",
                " ||||||||||||||||||||||__|||||||||||||||||||||| ",
                " ||||||||||||||||||||||__|||||||||||||||||||||| ",
                " ||C....MMMMMMMMMM...||__||                     ",
                " ||C.i..M########Mi..||__||                     ",
                " ||C....MMMMMMMMMM...||__||                     ",
                " ||C....MMMMMMMMMM...+_II||                     ",
                " ||C....MMMMMMMMMM...||__||                     ",
                " ||C....M########M...||__||                     ",
                " ||C.i..MMMMMMMMMMi..||__||                     ",
                " ||.................2||__||                     ",
                " |||********|||||||||||__||                     ",
                " |||********|||||||||||__|||||||                ",
                " |..............||..z..__.z.x.||                ",
                " |..............||..x..__.....||                ",
                " |..............||..X..II..X..||                ",
                " |..............||.Z...__..z..||                ",
                " |..............||.z...__....2||                ",
                " |..............|||||||**|||||||                ",
                " |..............|||||||**|||||||                ",
                " |.......................|                      ",
                " |.......................|                      ",
                " |.......................|                      ",
                " |.......................|                      ",
                " |.......................|                      ",
                " VVVVVVVVVVVVVVVVVVVVVVVVV                      "
            ],
        "palettes": [ "mdx_special_military_base_plt" ],
        "terrain": { " ": "t_region_groundcover" },
        "place_vehicles": [
            { "vehicle": "mdx_special_military_base_car", "x": [ 8 ], "y": [ 40 ], "chance": 90, "rotation": 90 },
            { "vehicle": "mdx_special_military_base_car", "x": [ 14 ], "y": [ 28 ], "chance": 50, "rotation": 180, "status": 0 }
          ]
        }
    },
    {
        "type": "mapgen",
        "method": "json",
        "om_terrain": [ 
            [ "mdx_special_military_base_roof_2", "mdx_special_military_base_roof_1" ],
            [ "mdx_special_military_base_roof_4", "mdx_special_military_base_roof_3" ]
        ],
        "weight": 100,
        "object": {
            "fill_ter": "t_open_air",
             "rows": [
                
                "                                                ",
                " .............................................. ",
                " .............................................. ",
                " .............................................. ",
                " .............................................. ",
                " .............................................. ",
                " .............................................. ",
                " .............................................. ",
                " .............................................. ",
                " .............................................. ",
                " .............................................. ",
                " .............................................. ",
                " .............................................. ",
                " .............................................. ",
                " .............................................. ",
                " .............................................. ",
                " .............................................. ",
                " .............................................. ",
                " .............................................. ",
                " .............................................. ",
                " .............................................. ",
                " .............................................. ",
                " .............................................. ",
                " .............................................. ",
                " .............................................. ",
                " ...........................                    ",
                " ...........................                    ",
                " ...........................                    ",
                " ...........................                    ",
                " ...........................                    ",
                " ...........................                    ",
                " ...........................                    ",
                " ...........................                    ",
                " ...........................                    ",
                "                ................                ",
                "                ................                ",
                "                ................                ",
                "                ................                ",
                "                ................                ",
                "                ................                ",
                "                ................                ",
                "                ................                ",
                "                                                ",
                "                                                ",
                "                                                ",
                "                                                ",
                "                                                ",
                "                                                "
            ],
            "terrain": {
                ".": "t_flat_roof"
            }
        }
    }
]