[
    {
        "type": "mapgen",
        "method": "json",
        "weight": 1000,
        "om_terrain": [ "mdx_omega_outpost" ],"object": {
            "fill_ter": "t_floor",
            "rows": [
                
                "                        ",
                "  ....................  ",
                "  ....................  ",
                "  ..||||||||||||||||..  ",
                "  ..|.>..........<.|..  ",
                "  ..|...        ...|..  ",
                "  ..+...        ...+..  ",
                "  ..|...        ...|..  ",
                "  ..||||        ||||..  ",
                "                        ",
                "                        ",
                "                        ",
                "                        ",
                "                        ",
                "                        ",
                "                        ",
                "                        ",
                "                        ",
                "                        ",
                "                        ",
                "                        ",
                "                        ",
                "                        ",
                "                        "
            ],
        "palettes": [ "mdx_omega_outpost_plt" ],
        "terrain": { " ": "t_water_dp" }
        }
    },
    {
        "type": "mapgen",
        "method": "json",
        "weight": 1000,
        "om_terrain": [ "mdx_omega_outpost_basement_1" ],"object": {
            "fill_ter": "t_thconc_floor",
            "rows": [
                
                "                        ",
                "                        ",
                "                        ",
                "                        ",
                "                        ",
                " |||||||||||||||||||||  ",
                " |||||||||||||||||||||  ",
                " ||.><6aaaaa|ff.tsss||  ",
                " ||.'.*Z.'..+...'.Ds||  ",
                " ||rrr|wwwww|.Z.....||  ",
                " ||||||||||||..{|+|+||  ",
                " ||??m??m??t|..{|.|.||  ",
                " ||....'.Z..+..{|o|o||  ",
                " ||==.==.==.||||||||||  ",
                " |||||||||||||||||||||  ",
                " |||||||||||||          ",
                "                        ",
                "                        ",
                "                        ",
                "                        ",
                "                        ",
                "                        ",
                "                        ",
                "                        "
            ],
        "palettes": [ "mdx_omega_outpost_plt" ],
        "terrain": { " ": "t_water_dp" }
        }
    },
    {
        "type": "mapgen",
        "method": "json",
        "weight": 1000,
        "om_terrain": [ "mdx_omega_outpost_basement_2" ],"object": {
            "fill_ter": "t_thconc_floor",
            "rows": [
                
                "                        ",
                " |||||                  ",
                " |||||                  ",
                " ||>||||||||||||||      ",
                " ||.||||||||||||||      ",
                " ||............'||      ",
                " ||||||||||||||.||      ",
                " ||B..+.'.+...|.||      ",
                " ||B'.||+||.'.|.||      ",
                " ||B..|O'O|...|.||      ",
                " ||MMM|O'O|.Qq|.||      ",
                " |||||||+||||||.||      ",
                " ||.....'.....+.||      ",
                " ||||||||||||||'||      ",
                " ||||||||||||||X||      ",
                " |||||||||||||||||      ",
                " |||||||||||||||||      ",
                "                        ",
                "                        ",
                "                        ",
                "                        ",
                "                        ",
                "                        ",
                "                        "
            ],
        "palettes": [ "mdx_omega_outpost_plt" ],
        "terrain": { " ": "t_water_dp" }
        }
    },
    {
        "type": "mapgen",
        "method": "json",
        "om_terrain": "mdx_omega_outpost_roof",
        "weight": 100,
        "object": {
            "fill_ter": "t_open_air",
             "rows": [
                
                "                        ",
                "                        ",
                "                        ",
                "    ................    ",
                "    ..<.............    ",
                "    ................    ",
                "    ................    ",
                "    ................    ",
                "    ................    ",
                "                        ",
                "                        ",
                "                        ",
                "                        ",
                "                        ",
                "                        ",
                "                        ",
                "                        ",
                "                        ",
                "                        ",
                "                        ",
                "                        ",
                "                        ",
                "                        ",
                "                        "
            ],
            "terrain": {
                ".": "t_flat_roof",
                "<": "t_ladder_down"
            }
        }
    }
]
