[
    {
        "type": "mapgen",
        "method": "json",
        "weight": 1000,
        "om_terrain": [ 
            [ "mdx_special_military_base_2", "mdx_special_military_base_1" ],
            [ "mdx_special_military_base_4", "mdx_special_military_base_3" ]
        ],
        "object": {
            "fill_ter": "t_floor",
            "rows": [
                
                "                                                ",
                " |||||||||||||||||||||||||||||||||||||||||||||| ",
                " |||||||||||||||||||||||||||||||||||||||||||||| ",
                " ||GG.G.GG|mm.mm||||q.q__q.q|||||FFFODkkDOFFF|| ",
                " ||i..Gz.i|m...m|||.Q.Q__Q.Q.||||.....i..z...|| ",
                " ||GG.G.GG|.....||W.._.__._..W|||..z..x......|| ",
                " ||.z.G...|m.i.m||w...____...w|||bTTbbTbT..z.|| ",
                " ||GG.G.GG|m.x.m||w____II____w|||bTTbbTbT....|| ",
                " ||...x.z.|..Z..||w...____...w|||bTTbbTbT.z..|| ",
                " ||a..iZ..|m...m||W.._.__._..W|||bTTbbTbT....|| ",
                " ||aaaa...|mm.mm|||W_..__.._W||||bTTbbTbT.Z..|| ",
                " ||||||||+|||+||||||W..__..W|||||..z..i..x...|| ",
                " ||=uu=|._z.._.||||||||__||||||||....z.......|| ",
                " ||=..=|._..__.||||||||II|||||||||||||||||+|||| ",
                " ||.x..|._.i_..|=v=v=|X__X|o.+.|AA.AssA.A...P|| ",
                " ||=..=|._.x_z.|=.=.=||__|||||.|......i..x...|| ",
                " ||=iz=|._.z_..|..x..||__||o.+.|..x..ppp..z.E|| ",
                " ||L...|._.._._+.zxiL|XIIX||||i|...z.ppp.....|| ",
                " ||.z..+_______+..Z..||__||o.+.|ST..Z.iz.z..t|| ",
                " ||=.Z=|..._.x.|=.=.=||__|||||.|STTT....x....|| ",
                " ||=..=|.Z._...|=v=v=||**||o.+.|SSSSS........|| ",
                " |||||||||++|||||||||||**|||||+|||||||||||+|||| ",
                " ||....x.i..z..Z...x...II....z......x.i......|| ",
                " ||||||||||||||||||||||__|||||||||||||||||||||| ",
                " ||||||||||||||||||||||__|||||||||||||||||||||| ",
                "                    |||__|||                    ",
                "                    |||__|||                    ",
                "                    |||__|||                    ",
                "                    |||II|||                    ",
                "                    |||__|||                    ",
                "                    |||__|||                    ",
                "                    |||__|||                    ",
                "                    |||__|||                    ",
                "                    |||__|||                    ",
                " ||||||||||||||||||||||__|||||||                ",
                " |..............||..z..__.z.x.||                ",
                " |..............||..x..__.....||                ",
                " |..............||..X..II..X..||                ",
                " |..............||.Z...__..z..||                ",
                " |..............||.z...__.....||                ",
                " |..............|||||||**|||||||                ",
                " |..............|||||||**|||||||                ",
                " |.......................|                      ",
                " |.......................|                      ",
                " |.......................|                      ",
                " |.......................|                      ",
                " |.......................|                      ",
                " VVVVVVVVVVVVVVVVVVVVVVVVV                      "
            ],
        "palettes": [ "mdx_special_military_base_plt" ],
        "terrain": { " ": "t_region_groundcover" },
        "place_vehicles": [
            { "vehicle": "special_military_base_car", "x": [ 9 ], "y": [ 41 ], "chance": 80, "rotation": 90, "status": 0 }
          ]
        }
    },
    {
        "type": "mapgen",
        "method": "json",
        "om_terrain": [ 
            [ "mdx_special_military_base_roof_2", "mdx_special_military_base_roof_1" ],
            [ "mdx_special_military_base_roof_4", "mdx_special_military_base_roof_3" ]
        ],
        "weight": 100,
        "object": {
            "fill_ter": "t_open_air",
             "rows": [
                
                "                                                ",
                " .............................................. ",
                " .............................................. ",
                " .............................................. ",
                " .............................................. ",
                " .............................................. ",
                " .............................................. ",
                " .............................................. ",
                " .............................................. ",
                " .............................................. ",
                " .............................................. ",
                " .............................................. ",
                " .............................................. ",
                " .............................................. ",
                " .............................................. ",
                " .............................................. ",
                " .............................................. ",
                " .............................................. ",
                " .............................................. ",
                " .............................................. ",
                " .............................................. ",
                " .............................................. ",
                " .............................................. ",
                " .............................................. ",
                " .............................................. ",
                "                    ........                    ",
                "                    ........                    ",
                "                    ........                    ",
                "                    ........                    ",
                "                    ........                    ",
                "                    ........                    ",
                "                    ........                    ",
                "                    ........                    ",
                "                    ........                    ",
                "                ................                ",
                "                ................                ",
                "                ................                ",
                "                ................                ",
                "                ................                ",
                "                ................                ",
                "                ................                ",
                "                ................                ",
                "                                                ",
                "                                                ",
                "                                                ",
                "                                                ",
                "                                                ",
                "                                                "
            ],
            "terrain": {
                ".": "t_flat_roof"
            }
        }
    }
]