[
    {
        "type": "mapgen",
        "method": "json",
        "weight": 1000,
        "om_terrain": [ "mdx_lmoe_bunker" ],"object": {
            "fill_ter": "t_floor",
            "rows": [
                
                "                        ",
                "                        ",
                "                        ",
                "                        ",
                "                        ",
                "                        ",
                "                        ",
                "                        ",
                "                        ",
                "       |==||||==|       ",
                "       |>..<<.rL|       ",
                "       =........=       ",
                "       =........=       ",
                "       |........|       ",
                "       |==|++|==|       ",
                "                        ",
                "                        ",
                "                        ",
                "                        ",
                "                        ",
                "                        ",
                "                        ",
                "                        ",
                "                        "
            ],
        "palettes": [ "mdx_lmoe_bunker_plt" ],
        "terrain": { " ": "t_region_groundcover" }
        }
    },
    {
        "type": "mapgen",
        "method": "json",
        "weight": 1000,
        "om_terrain": [ "mdx_lmoe_bunker_basement_1" ],"object": {
            "fill_ter": "t_thconc_floor",
            "rows": [
                
                "||||||||||||||||||||||||",
                "||||||||||||||||||||||||",
                "||||||||||||||||||||||||",
                "||||||||||||||||||||||||",
                "||||||||||||||||||||||||",
                "|||||do|HH|>>|ii..C|||||",
                "|||||.,+Z.|Z.|TT..C|||||",
                "||||||||,.+.Z|ii,.Q|||||",
                "|||||O,+.t|,,|.Z..q|||||",
                "|||||||||||Z.+..Z.E|||||",
                "||||J.aa.J|rr|t.Z.W|||||",
                "||||U.,,.S|||||||+||||||",
                "||||U....S|sg|BBB..|||||",
                "|||||-|||||+||Z.Z.Z|||||",
                "|||||.h.j.k..|t.ZTf|||||",
                "|||||.Z.,.Z..+.Z,Tf|||||",
                "||||||+||+||+|.Z..A|||||",
                "|||||D.|D.|D.|ZZ.Tf|||||",
                "|||||we|we|we|rffff|||||",
                "||||||||||||||||||||||||",
                "||||||||||||||||||||||||",
                "||||||||||||||||||||||||",
                "||||||||||||||||||||||||",
                "||||||||||||||||||||||||"
            ],
        "palettes": [ "mdx_lmoe_bunker_plt" ],
        "terrain": { " ": "t_region_groundcover" }
        }
    },
    {
        "type": "mapgen",
        "method": "json",
        "om_terrain": "mdx_lmoe_bunker_roof",
        "weight": 100,
        "object": {
            "fill_ter": "t_open_air",
             "rows": [
                
                "                        ",
                "                        ",
                "                        ",
                "                        ",
                "                        ",
                "                        ",
                "                        ",
                "                        ",
                "                        ",
                "       ..........       ",
                "       .<.####...       ",
                "       ...####...       ",
                "       ...####...       ",
                "       ...####...       ",
                "       ..........       ",
                "                        ",
                "                        ",
                "                        ",
                "                        ",
                "                        ",
                "                        ",
                "                        ",
                "                        ",
                "                        "
            ],
            "terrain": {
                ".": "t_flat_roof",
                "#": "t_flat_roof",
                "<": "t_ladder_down"
            },
            "furniture": {
                "#": "f_solar_unit"
             }
        }
    }
]
