[
    {
        "type": "mapgen",
        "method": "json",
        "weight": 1000,
        "om_terrain": [ "mdx_police_outpost" ],"object": {
            "fill_ter": "t_floor",
            "rows": [
                
                "                        ",
                "                        ",
                "  ||||||||||||||||||||  ",
                "  |..................|  ",
                "  |..........=.=.=.=.|  ",
                "  |..LLLL....=.=.=.=.|  ",
                "  |..LLLL............|  ",
                "  |..........=.=.=.=.|  ",
                "  |..........=.=.=.=.|  ",
                "  |..LLLL............|  ",
                "  |..LLLL....=.=.=.=.|  ",
                "  |..........=.=.=.=.|  ",
                "  |..................|  ",
                "  |..................|  ",
                "  |..............ccc.|  ",
                "  |s.a.......cTc.TTT.|  ",
                "  |s.T.......cTc.ccc.|  ",
                "  |s.........cTc.ccc.|  ",
                "  |sss...........TTT.|  ",
                "  |..................|  ",
                "  |CCCCC|||++|||FFFFF|  ",
                "  |||||||......|||||||  ",
                "                        ",
                "                        "
            ],
        "palettes": [ "mdx_police_outpost_plt" ],
        "terrain": { " ": "t_region_groundcover" },
        "place_monsters": [ { "monster": "GROUP_POLICE", "x": [ 0, 23 ], "y": [ 0, 23 ], "repeat": 15 } ]
        }
    }
]