[
    {
        "type": "mapgen",
        "method": "json",
        "weight": 1000,
        "om_terrain": [ "mdx_cybernetic_cache" ],"object": {
            "fill_ter": "t_floor",
            "rows": [
                
                "                        ",
                "            ...         ",
                "           .....        ",
                "         ........       ",
                "       .............    ",
                "    ....||||||||||...   ",
                "    ....||||||||||..... ",
                "     ...||||||||||....  ",
                "   .....||||cc||||...   ",
                "     ...||||||||||....  ",
                "     ...||||||||||....  ",
                "      ..||||||||||....  ",
                "     ................   ",
                "      .............     ",
                "        ..........      ",
                "          .....         ",
                "          ...           ",
                "           .            ",
                "                        ",
                "                        ",
                "                        ",
                "                        ",
                "                        ",
                "                        "
            ],
        "palettes": [ "mdx_cybernetic_cache_plt" ],
        "place_monster": [ 
            { "monster": "mon_zomborg", "x": [ 0, 23 ], "y": [ 0, 23 ], "pack_size": [ 5, 10 ] } 
        ]
        }
    }
]
