[
    {
        "type": "mapgen",
        "method": "json",
        "weight": 1000,
        "om_terrain": [ "mdx_special_bunker" ],"object": {
            "fill_ter": "t_floor",
            "rows": [
                
                "                        ",
                "  ||||||||||||||||||||  ",
                " |||||||||||||||||||||| ",
                " ||=.=.=.=|<<|..Z....|| ",
                " ||=.=I=.=|..|vtv.vtv|| ",
                " ||.Z.,.Z.|,,|vtv.vtv|| ",
                " ||=.UUU.=|..|vtv,vtv|| ",
                " ||=.U|U.=|Z.|.Z.Z.Z.|| ",
                " ||..U|U..|I.|..Z..Z.|| ",
                " ||=.UUU.=|..|.Iwww..|| ",
                " ||=.Z,..=|.Z|..www..|| ",
                " |||||+||||,,|..wwwI.|| ",
                " ||..H...!|.Z|.Z.Z...|| ",
                " ||[[..Z..+..|a..Z..a|| ",
                " ||oo.,Z..+.Z|a..Z..a|| ",
                " ||[[.Z...|Z.|....I..|| ",
                " ||.I..Z..|..+...Z.Z.|| ",
                " ||..r.e..|I.|...H...|| ",
                " ||+|||||+|..|.Z.,Z..|| ",
                " ||..$|$..|.||.....Z.|| ",
                " ||&.T|T.&|.||.fffc&.|| ",
                " ||||||||||*||||||||||| ",
                "  |||||||||*1|||||||||  ",
                "                        "
            ],
        "palettes": [ "mdx_special_bunker_plt" ],
        "terrain": { " ": "t_region_groundcover" }
        }
    },
    {
        "type": "mapgen",
        "method": "json",
        "weight": 1000,
        "om_terrain": [ "mdx_special_bunker_basement_1" ],"object": {
            "fill_ter": "t_thconc_floor",
            "rows": [
                
                "||||||||||||||||||||||||",
                "||||||||||||||||||||||||",
                "||||||||||||||||||||||||",
                "||||||||||||||||||||||||",
                "||||||||||||||||||||||||",
                "|||||||||||>>|||||||||||",
                "|||||||||||__|||||||||||",
                "||||||||||1**|||||||||||",
                "||||||||x______x||||||||",
                "|||||||||||++|||||||||||",
                "|||||||ggg____ggg|||||||",
                "|||||||____,,____|||||||",
                "|||||||__________|||||||",
                "|||||||qqq_WW_qqq|||||||",
                "|||||||qqq_WW_qqq|||||||",
                "|||||||____,,____|||||||",
                "|||||||__________|||||||",
                "|||||||gggqqqqggg|||||||",
                "||||||||||||||||||||||||",
                "||||||||||||||||||||||||",
                "||||||||||||||||||||||||",
                "||||||||||||||||||||||||",
                "||||||||||||||||||||||||",
                "||||||||||||||||||||||||"
            ],
        "palettes": [ "mdx_special_bunker_plt" ],
        "terrain": { " ": "t_region_groundcover" }
        }
    },
    {
        "type": "mapgen",
        "method": "json",
        "om_terrain": "mdx_special_bunker_roof",
        "weight": 100,
        "object": {
            "fill_ter": "t_open_air",
             "rows": [
                
                "                        ",
                "  ....................  ",
                " ...................... ",
                " ...................... ",
                " ...................... ",
                " ...................... ",
                " ...................... ",
                " ...................... ",
                " ...................... ",
                " ...................... ",
                " ...................... ",
                " ...................... ",
                " ...................... ",
                " ...................... ",
                " ...................... ",
                " ...................... ",
                " ...................... ",
                " ...................... ",
                " ...................... ",
                " ...................... ",
                " ...................... ",
                " ...................... ",
                "  ....................  ",
                "                        "
            ],
            "terrain": {
                ".": "t_flat_roof"
            }
        }
    }
]
